# #############
#             #
# ######### ###
#   #     #   #
### # ### ### #
#     #   #   #
# ####### # ###
#  #      #   #
#### ######## #
#         #   #
######### #####  
#             #
############# #