# #####################
#     #       #       #
### # ### ### ##### ###
#   #     #       #   #
# ### ### ####### ### #
#     #   #     #     #
##### ##### ### #######
#         #   #       #
### ####### ##### ### #
#   #         #   #   #
# ##### ### ### #######
#       #     #       #
##################### #