# #########
#   #     #
### # ### #
#     #   #
# ####### #
# #       #
# ####### #
#       # #
######### #